:'######:::::'###::::'##::::::::'######::'##::::'##:'##::::::::::'###::::'########::'#######::'########::
'##... ##:::'## ##::: ##:::::::'##... ##: ##:::: ##: ##:::::::::'## ##:::... ##..::'##.... ##: ##.... ##:
 ##:::..:::'##:. ##:: ##::::::: ##:::..:: ##:::: ##: ##::::::::'##:. ##::::: ##:::: ##:::: ##: ##:::: ##:
 ##:::::::'##:::. ##: ##::::::: ##::::::: ##:::: ##: ##:::::::'##:::. ##:::: ##:::: ##:::: ##: ########::
 ##::::::: #########: ##::::::: ##::::::: ##:::: ##: ##::::::: #########:::: ##:::: ##:::: ##: ##.. ##:::
 ##::: ##: ##.... ##: ##::::::: ##::: ##: ##:::: ##: ##::::::: ##.... ##:::: ##:::: ##:::: ##: ##::. ##::
. ######:: ##:::: ##: ########:. ######::. #######:: ########: ##:::: ##:::: ##::::. #######:: ##:::. ##:
:......:::..:::::..::........:::......::::.......:::........::..:::::..:::::..::::::.......:::..:::::..::