:'######:::'#######::'########::'########:::::'######::'########::'##::::'##::'######::'##::::'##:'########:'########::
'##... ##:'##.... ##: ##.... ##: ##.....:::::'##... ##: ##.... ##: ##:::: ##:'##... ##: ##:::: ##: ##.....:: ##.... ##:
 ##:::..:: ##:::: ##: ##:::: ##: ##:::::::::: ##:::..:: ##:::: ##: ##:::: ##: ##:::..:: ##:::: ##: ##::::::: ##:::: ##:
 ##::::::: ##:::: ##: ##:::: ##: ######:::::: ##::::::: ########:: ##:::: ##:. ######:: #########: ######::: ########::
 ##::::::: ##:::: ##: ##:::: ##: ##...::::::: ##::::::: ##.. ##::: ##:::: ##::..... ##: ##.... ##: ##...:::: ##.. ##:::
 ##::: ##: ##:::: ##: ##:::: ##: ##:::::::::: ##::: ##: ##::. ##:: ##:::: ##:'##::: ##: ##:::: ##: ##::::::: ##::. ##::
. ######::. #######:: ########:: ########::::. ######:: ##:::. ##:. #######::. ######:: ##:::: ##: ########: ##:::. ##:
:......::::.......:::........:::........::::::......:::..:::::..:::.......::::......:::..:::::..::........::..:::::..::